level_1 = {
	"width" : 15,
	"height" : 15,
	"tiles" :
		[
			1,1,1,1,1,1,1,1,1,1,1,1,1,1,1,
			1,0,0,0,0,0,0,0,0,1,0,0,0,0,1,
			1,0,0,0,0,0,0,0,0,1,0,0,0,0,1,
			1,0,0,0,0,0,0,0,0,1,0,0,0,0,1,
			1,0,0,0,0,0,0,0,0,1,1,0,0,1,1,
			1,0,0,0,0,0,0,0,0,0,0,0,0,0,1,
			1,0,0,0,0,0,0,0,0,0,0,0,0,0,1,
			1,0,0,0,0,0,0,0,0,0,0,0,0,0,1,
			1,0,0,0,0,0,0,0,0,0,0,0,0,0,1,
			1,0,0,0,0,0,0,0,0,0,0,0,0,0,1,
			1,0,0,0,0,0,0,0,0,0,0,0,0,0,1,
			1,0,0,0,0,0,0,0,0,0,0,0,0,0,1,
			1,0,0,0,0,0,0,0,0,0,0,0,0,0,1,
			1,0,0,0,0,0,0,0,0,0,0,0,0,0,1,
			1,1,1,1,1,1,1,1,1,1,1,1,1,1,1,
		]
}
